xxxxxxxxxxx
x---------x
x-x-x-x-x-x
x--x-x-x--x
x-x-x-x-x-x
x--x-x-x--x
x-x-x-x-x-x
x--x-x-x--x
x-x-x-x-x-x
x---------x
xxxxxxxxxxx