{
    "titre": "Niveau 5",
    "niveau": 5,
    "labyrinthe": [
        "X X X X X X X X X X X X X X X",
        "X - - - - - - - - - - - - - X",
        "X - - - - - - - - - - - - - X",
        "X - - - - - - - - - - - - - X",
        "X - - - - - - - - - - - - - X",
        "X - - - - - - - - - - - - - X",
        "X - - - - - - - - - - - - - X",
        "X - - - - - - - - - - - - - X",
        "X - - - - - - - - - - - - - X",
        "X - - - - - - - - - - - - - X",
        "X - - - - - - - - - - - - - X",
        "X - - - - - - - - - - - - - X",
        "X - - - - - - - - - - - - - X",
        "X - - - - - - - - - - - - - X",
        "X X X X X X X X X X X X X X X"
    ],
    "spawnPos": [7, 13],
    "monstres": [
    ],
	"items": [
	{
            "id": 1,
            "pos": [7, 7]
        }
    ]
}
